10,10
#,#,#,#,#,#,#,#,#,#
#, , ,#,#,#,#,#,#,#
#,#, , , , , , ,#,#
#,#, ,#,#,#,#, ,#,#
#,#, , , ,#,#, ,#,#
#,#,#,#, ,#,#, , , 
#,#, ,#, ,#,#,#,#,#
#,#, , , , ,#, ,#,#
#,#, ,#,#,#,#, ,#,#
#,#, ,#,#,#,#,#,#,#
9,2
5,9
